ARSENAL	Ignazio Consentino	Premier League	1
ASTON VILLA	Raffaele e Antonio	Premier League	0
BOURNEMOUTH	Pasquale Ambrosio	Premier League	0
BRENTFORD	Raffaele & Eugenio	Premier League	8
BRIGHTON	Salvatore Miranda (ottav)	Premier League	53
BURNLEY	Luciano e Antonio	Premier League	1
CHELSEA	Agostino Miranda	Premier League	25
CRYSTAL PALACE	Antonio & Salvatore	Premier League	0
EVERTON	Davide Migliore	Premier League	29
FULHAM	Francesco Somma	Premier League	3
LEEDS	Antonio Tramontano	Premier League	0
LIVERPOOL	Giuseppe Sicignano	Premier League	20
MAN UNITED	Francesco Annunziata	Premier League	50
MANCHESTER CITY	Emanuele Forte	Premier League	0
NEWCASTLE	Vincenzo Miranda	Premier League	33
NOTTINGHAM	Giuseppe Boccia	Premier League	60
SUNDERLAND	Francesco Miranda Pic.	Premier League	0
TOTTENHAM	Giuliano Boccia	Premier League	1
WEST HAM	Francesco Miranda Gra.	Premier League	4
WOLVERHAMPTON	Marco Franzese	Premier League	48
ALAVES	Giuseppe Luongo	Liga Spagnola	143
ATLETICO MADRID	Alessandro Boccia	Liga Spagnola	0
ATLETICO BILBAO	Salvatore Ambrosio	Liga Spagnola	16
BARCELLONA	Salvator Miranda	Liga Spagnola	0
BETIS	Salvatore Ambrosio	Liga Spagnola	32
CELTA VIGO	Francesco Raggio	Liga Spagnola	16
ELCHE	Aniello D'ascoli	Liga Spagnola	98
ESPANYOL	Antonio Miranda	Liga Spagnola	1
GETAFE	Francesco DeVito	Liga Spagnola	19
GIRONA	Umberto Di Mauro	Liga Spagnola	0
LEVANTE	Renato e Daniele	Liga Spagnola	116
MAIORCA	Luigi Duraccio	Liga Spagnola	63
OSASUNA	Claudio Ambrosio	Liga Spagnola	0
OVIEDO	Guglielmo e Aldo	Liga Spagnola	71
REAL MADRID	Ettore Boccia	Liga Spagnola	5
REAL SOCIETAD	Antonio Pagano	Liga Spagnola	5
REAL VALLECANO	Saverio e francesco	Liga Spagnola	8
SIVIGLIA	Giuseppe Miranda	Liga Spagnola	4
VALENCIA	Gianluca Miranda	Liga Spagnola	11
VILLAREAL	Giuseppe Miranda	Liga Spagnola	8
AUGSBURG	Giuseppe Innusa	Bundesliga	30
BAYERN MONACO	Eddy Brachini	Bundesliga	21
BOCHUM	Gabriele Mingotti	Bundesliga	0
COLONIA	Aliperti Umberto	Bundesliga	20
DORTMUND	Giuseppe Annunziata	Bundesliga	84
EINTRACHT	Luciano D'avino	Bundesliga	0
FRIBURGO	Giuseppe Ambrosio	Bundesliga	0
HEIDENHEIM	Angelo Caldarelli	Bundesliga	0
HOFFENHEIM	Rito napolitano  	Bundesliga	41
HOLSTEL KIEL	Gaetano e Giovanni	Bundesliga	0
LEVERKUSEN	Vincenzo Carotenuto	Bundesliga	0
LIPSIA	Marco Russo	Bundesliga	2
MAINZ	Alessio Dilisio	Bundesliga	0
MONCHENGLADBACH	Luigi Pizzella	Bundesliga	10
NORIMBERGA	Carlo D’alpa	Bundesliga	0
ST PAULI	Guido e Nicola	Bundesliga	25
STOCCARDA	Daniele Coppola	Bundesliga	6
UNION BERLINO	Daniele Olmetto	Bundesliga	0
WERDER BREMA	Salvo Innusa	Bundesliga	1
WOLFSBURG	Giuseppe Ianni 	Bundesliga	0
ANGERS	Alessandro e Antonio	Ligue 1	46
AUXERRE	Angelo & Giuseppe	Ligue 1	23
BREST	Luca Battello	Ligue 1	0
LE HAVRE	Annibale Mazzeo	Ligue 1	31
LENS	Alessandro Amato	Ligue 1	0
LILLE	Leonardo e Andrea	Ligue 1	69
LIONE	Gabriele Micali	Ligue 1	0
LORIENT	Omer Feldi	Ligue 1	17
MARSIGLIA	Luca Matera 	Ligue 1	31
METZ	Salvatore Franzese	Ligue 1	0
MONACO	Claudio Ambrosio	Ligue 1	14
NANTES	Antonio Langella	Ligue 1	75
NIZZA	Maurizio Beghi	Ligue 1	4
PARIS FC	Davide Ricciutelli	Ligue 1	69
PSG	Benito Marino	Ligue 1	40
REIMS	Stefano Delli Castelli	Ligue 1	31
RENNES	Alessandro Nicolosi	Ligue 1	94
SAINT ETIENNE	Roberto Saverino	Ligue 1	59
STRASBURGO	Manuel Massaro	Ligue 1	1
TOLOSA	Giampaolo Rizzuti	Ligue 1	38
ATALANTA	Antonio Seggioli	Serie A	0
BOLOGNA	Gabriele e Michele	Serie A	0
CAGLIARI	Mattia Danesin	Serie A	0
COMO	Carmine Altilio	Serie A	0
CREMONESE	Daniele Salsi	Serie A	0
FIORENTINA	Alberto Pisano	Serie A	0
GENOA	Vincenzo e Miky	Serie A	242
INTER	Angelo Catrini	Serie A	28
JUVENTUS	Massimo Bufano	Serie A	7
LAZIO	Marco Cesareo	Serie A	0
LECCE	Flavio Del Monego	Serie A	44
MILAN	Nello e Donato	Serie A	74
NAPOLI	Luciano Modugno	Serie A	0
PARMA	Fabrizio Amati	Serie A	0
PISA	Matteo Profeti	Serie A	0
ROMA	Fabio e Francesco	Serie A	101
SASSUOLO	Damiano Andalò	Serie A	0
TORINO	Gianluca Ristallo	Serie A	36
UDINESE	Michele Cotugno	Serie A	0
VERONA	Marco Ettore E Salvatore	Serie A	11
